##########
#        #
#         
#   #    #
#  ##    #
#    ##  #
#    #   #
#        #    
#        #
##### ####

Door,9,2,room6,1,2
Door,5,9,room4,5,1
Skeleton,2,2
Bat,2,7
Bat,7,2
Skeleton,7,7
