##########
#    #   #
   # # # #
#  #   # #
######## #
#      # #
### #  # #
  # #  # #
#   #    #
##########

Skeleton,1,5
Skeleton,7,8
Skeleton,1,2
Door,0,7,room2,8,7
Door,0,2,room2,8,2


