#### #####
#      # #
#      #  
#      # #
#      # #
#      # #
#      # #
         #    
#        #
##########

Door,0,7,room4,8,7
Door,9,2,room8,1,2
Door,4,0,room6,4,8
Bat,3,2
Bat,5,2
Bat,4,3
